##############################
#                            #
# oo                         #
# ##                         #
#  @     #@#o#######  @@     #
#   #       #o#       @      #
# #         #o   #           #
#   #                        #
# @           #      @       #
#   #o                       #
#      #o     @    #o        #
# @    #o                    #
# A    #o    @               #
##############################