####################
#                  #
#A  @     @        #
### #          @   #
#oo  # @      ##   #
####           ##  #
#oo  @ ##@         #
#oo  @       @     #
#oo   ####  #      #
####################