###################
#                o#
#     @ #######  ##
#A @   @          #
#            #  @ #
#      @@         #
#  #####          #
#      @@         #
#                 #
#                 #
#                 #
#               oo#
#ooo############oo#
###################