########
#      #
#A@   o#
#      #
#     @#
#     o#
########