############
# A        #
#          #
#          #
# o @      #
#          #
#          #
############